NO ./textures/test.png
SO ./textures/test.png
WE ./textures/texture_BR.png
EA ./textures/test.png

C 0,0,255
F 100,100,100

        1111111111111111111111111
        1000000000110000000000001
        1011000001110000000000001
        1001000000000000000000001
111111111011000001110000000000001
100000000011000001110111111111111
11110111111111011100000010001
11110111111111011101000010001
11000000110101011100000000001
10000100000000001100000010001
10000000000000001101011110001
11000001110101011111011000N0111
11110111 1110101 101111000001
1111111111111111 111111111111