NO      ./path_to_the_north_texture1
SO 
WE ./path_to_the_west_texture2
EA ./path_to_the_east_texture3

F 142,36,170
C 98,0,234

        1111111111111111111111111
        1000000000110000000000001
        1011000001110000000000001
        1001000000000000000000001
111111111011000001110000000000001
100000000011000001110111111111111
11110111111111011100000010101
11110111111111011101010010001
11000000110101011100000010001
10000100000000001100000010001
10000000000000001101010000001
11000001110101011111011000N0111
11110111 1110101 101111000001
1111111111111111 111111111111