NO      ./path_to_the_north_texture1
SO 
WE ./path_to_the_west_texture2
EA ./path_to_the_east_texture3

C 0,0,255
F 100,100,100

        1111111111111111111111111
        1000000000110000000000001
        1011000001110000000000001
        1001000000000000000000001
111111111011000001110000000000001
100000000011000001110111111111111
11110111111111011100000000001
11110111111111011101000000001
11000000110101011100000000001
10000100000000001100000000001
100000000000000011010100N0001
1100000111010101111101100000111
11110111 1110101 101111000001
1111111111111111 111111111111