NO      ./path_to_the_north_texture1
SO 
WE ./path_to_the_west_texture2
EA ./path_to_the_east_texture3

F 142,36,170
C 98,0,234

1111111111111111111111111
1000000000110000000000001
1011000001110000000000001
1001000000000000000000001
11111111101100N0011100001
1000000000110000011101111
1111011111111101110000001
1111011111111101110101001
1111111111111111111111111
